#####################
#####################
#####X######+########
###==∙∙∙∙==∙∙∙∙∙==###
###==∙∙∙∙==∙∙∙∙∙==###
###∙∙####∙∙#####∙∙###
###∙SG###∙∙+####∙∙+##
###∙∙####∙∙#####∙∙###
##+∙∙####∙∙#####∙∙###
###∙∙+##+∙∙+###X∙∙###
###==∙∙∙∙==∙∙∙∙∙==###
###==∙∙∙∙==∙∙∙∙∙==###
########+######X#####
#####################
#####################