#####################
#####################
########+############
###==∙∙∙∙==∙∙∙∙∙==###
###==∙∙∙∙==∙∙∙∙∙==###
###∙∙####∙∙#####∙∙###
###∙∙####∙∙#####∙∙###
###∙∙+###∙∙#####∙∙###
###∙∙####∙∙#####∙∙###
###∙∙####∙∙##+##∙∙###
###==∙∙∙∙==∙∙∙∙∙==###
###==∙∙∙∙==∙∙∙∙∙==###
#####################
#####################
#####################