####+###X########+###
#==∙∙==∙∙==∙∙∙==∙∙==#
#==∙∙==∙∙==∙∙∙==∙∙==#
#∙SG#∙∙+#∙∙#X#∙∙+#∙∙#
+∙∙#+∙∙#+∙∙+#+∙∙#+∙∙+
#∙∙##∙∙##∙∙###∙∙##∙∙#
#∙∙+#∙∙+#∙∙#+#∙∙+#∙∙#
#==∙∙==∙∙==∙∙∙==∙∙==#
#==∙∙==∙∙==∙∙∙==∙∙==#
#∙∙#+∙∙#X∙∙#+#∙∙#+∙∙#
+∙∙##∙∙##∙∙+#+∙∙##∙∙+
#∙∙+#∙∙+#∙∙#+#∙∙X#∙∙#
#==∙∙==∙∙==∙∙∙==∙∙==#
#==∙∙==∙∙==∙∙∙==∙∙==#
####X###+########+###