#####################
#####################
########X############
###==∙∙∙∙==∙∙∙∙∙==###
###==∙∙∙∙==∙∙∙∙∙==###
###∙∙####∙∙#####∙∙###
###∙SG###∙∙#####∙∙###
###∙∙####∙∙#####∙∙###
###∙∙####∙∙#####∙∙###
###∙∙####∙∙+#+##∙∙###
###==∙∙∙∙==∙∙∙∙∙==###
###==∙∙∙∙==∙∙∙∙∙==###
#####################
#####################
#####################