#####∙####∙∙∙XX∙∙∙###
####∙∙∙∙∙∙∙######∙###
#∙X∙∙∙####∙######∙###
#∙###X####∙∙∙∙∙∙∙∙∙∙∙
#∙###∙∙∙∙∙∙##∙X####X∙
∙∙X∙∙∙#######∙∙####∙∙
#∙###∙#######X∙####∙X
#∙∙∙∙∙XX∙∙∙∙∙∙∙XXXX∙∙
#X∙XX∙∙∙∙XX∙XX∙∙∙∙∙∙∙
#X∙#####∙##∙####∙∙#∙∙
##∙∙####∙∙#∙∙##∙∙#∙∙#
##X∙###∙∙∙∙#∙∙∙∙#∙∙##
###∙∙#∙∙##∙∙#∙∙X∙∙###
###∙∙∙∙####∙∙∙#∙∙####
##∙∙∙∙######∙#∙∙#####