∙∙∙∙∙∙∙∙∙∙∙∙∙∙####∙##
∙#X#∙#####∙∙∙∙∙∙∙∙∙##
∙∙R∙∙#####∙R#∙∙∙##∙##
∙∙∙∙∙#####∙∙##∙∙∙#∙##
##∙∙∙#####∙∙###∙∙∙∙##
##∙#∙∙####∙∙#####∙∙##
##R##∙R##∙∙R∙###∙R∙R#
#∙∙∙##∙∙∙∙∙∙∙∙∙∙∙∙∙∙∙
∙∙∙∙∙#∙∙∙∙∙∙∙∙∙∙∙∙∙∙∙
#∙R∙##R##∙∙R∙###∙R∙∙∙
##∙###∙###∙∙#####∙∙∙#
##∙###∙###∙∙#####∙∙##
##R∙∙∙R∙∙∙∙R∙∙∙∙∙R###
##∙###∙#####∙∙∙∙∙####
##∙###∙######∙∙∙#####