#######∙∙∙∙∙∙∙#######
#######∙∙∙∙∙∙∙#######
#######∙∙∙∙∙∙∙#######
#######∙∙∙∙∙∙∙#######
#######∙∙∙∙∙∙∙#######
#######∙∙∙∙∙∙∙#######
#######∙∙∙∙∙∙∙#######
#######∙∙∙∙∙∙∙#######
#######∙∙∙∙∙∙∙#######
#######∙∙∙∙∙∙∙#######
#######∙∙∙∙∙∙∙#######
#######∙∙∙∙∙∙∙#######
#######∙∙∙∙∙∙∙#######
#####################
#######XXX#XXX#######