###∙∙∙∙∙∙∙∙∙∙∙∙∙∙∙∙∙∙
###∙R##∙R##∙R###R#X#∙
###∙∙∙∙∙∙∙∙∙∙##∙∙∙∙∙∙
###∙∙∙∙∙R∙∙∙R#∙∙∙∙∙∙∙
###∙∙######∙∙∙∙∙##∙##
###∙∙######∙@∙∙##∙∙##
###∙∙∙####∙∙∙∙##∙∙∙##
##∙∙R∙∙∙∙∙∙∙R##∙R#∙##
∙∙∙∙∙∙∙∙∙∙∙∙##∙∙##∙##
∙∙∙∙@∙∙∙@∙∙###∙∙##∙##
∙∙∙∙∙∙∙∙∙∙∙∙##∙∙##∙##
∙∙∙∙R∙∙∙R∙∙∙R∙∙∙R∙∙##
#######∙∙###∙∙####∙##
########∙∙###∙∙###∙##
#########∙∙∙R∙∙∙R∙∙##