##+####
#..#..#
#..#..#
#=###=#
#..#..#
+..=..+
#######