#+#####
#.=...#
#.#...#
#=#####
#..#..#
+..=..+
#######