#######
#...=.#
+...#.#
###=#.#
#.#.#.#
#.=.#.#
#+###+#