##+####
#...=.#
#...#.#
#=#####
#.#.#.#
#.=...+
#####+#