#+#####
#.#...#
#.=...#
#=#####
#..#..#
+..=..+
#######