#######
+...=.#
#...#.#
##=##=#
#...#.#
#...#.#
##+##+#