##+####
#...=.#
#...#.#
#=#####
#.#...#
#.=...+
####+##