####+##
#.....#
#=##=##
#.#...+
#.#####
#.=...#
####+##