#+#####
#.=...+
#.#####
#.=.#.#
#.#.#.#
#.#.=.#
#+#####