#+#####
#...#.#
#...=.#
#=#####
#.#...#
#.=...+
#####+#