#+#####
#...#.#
#...=.#
#=#####
#..=..#
+..#..#
#####+#