##+####
#...=.#
#...#.#
#=#####
#.#...+
#.=...#
#####+#