#+#####
#.....+
#=#####
#.#.#.#
#.=.=.#
#.#.#.#
#+#####