#######
+...=.+
#...#.#
##=##=#
#...#.#
#...#.#
##+####