#####+#
#...=.#
#=#=###
#.#...+
#.#####
#.=...#
####+##