#+#####
#.=...#
#.#.#.#
#=#####
#..#..#
+..=..#
#####+#