#######
#...=.#
+.#.#.#
###=#=#
#.#.#.#
#...#.#
#+###+#