#+#####
#...=.+
#=#####
#.#.#.#
#.=.#.#
#.#.=.#
#+#####