#####+#
#.=...#
#.#=###
#.#...+
#.#####
#.=...#
####+##