#+#####
#..#..+
#..#..#
##=##=#
#..#..#
+..=..#
#######